# IMPORTED
alias del="rm -rf"
alias rename="mv"
alias cl="clear"
alias git_rm="del .git/"

# NAVIGATION
alias ..="cd .."
alias ...="cd ../.."
alias ....="cd ../../.."
alias .....="cd ../../../.."


# COMMON DIRECTORIES
alias dl="cd ~/Downloads"
alias dt="cd ~/Desktop"
alias dc="cd ~/Documents"
alias p="cd ~/Documents/Projects"
alias apps="cd /Applications/"
alias pics="cd ~/Pictures/screenshots"
alias ?="pwd"

# RUNNING PROGRAMS
alias py="python3" 


# GIT
alias gf="git fetch"
alias gs="git status"
alias gd="git diff"
alias gb="git branch"
alias gc="git checkout"
alias commit="git commit -am"
alias gt="git checkout --track origin/"
alias pull="git pull"
alias push="git push"

# EASIER DOTFILE EDITING
alias bashrc="code ~/.bashrc"
